##  S ## ## ## ## ## ## ## ## ## ##
## [] [] [] [] ## [] [] [] [] [] ##
## [] ## ## [] ## [] ## ## ## [] ##
## [] ## [] [] ## [] [] [] ## [] G
## [] ## ## ## ## ## ## [] ## ## ##
## [] [] ## [] [] [] ## [] [] [] ##
## ## [] ## [] ## ## ## [] ## [] ##
## [] [] [] [] ## [] [] [] ## [] ##
## [] ## ## ## ## [] ## [] ## ## ##
## [] [] [] [] [] [] ## [] [] [] ##
## ## ## ## ## ## ## ## ## ## ## ##