## 00 ## ## ## ## ## ## ## ## ## ##
## 01 02 [] [] ## [] [] [] [] [] ##
## 03 ## ## [] ## [] ## ## ## [] ##
## [] ## [] [] ## [] [] [] ## [] []
## [] ## ## ## ## ## ## [] ## ## ##
## [] [] ## [] [] [] ## [] [] [] ##
## ## [] ## [] ## ## ## [] ## [] ##
## [] [] [] [] ## [] [] [] ## [] ##
## [] ## ## ## ## [] ## [] ## ## ##
## [] [] [] [] [] [] ## [] [] [] ##
## ## ## ## ## ## ## ## ## ## ## ##